############
#......#...#
#..##..#.#.#
#.##...#.#.#
#...####.#.#
#.#......#.#
#.#.####.#.#
S.#......#E#
