############
#....#.....#
#.##.#.###.#
#.#..#...#.#
#.#.###.##.#
#.#.....#..#
#.#####.####
S.#.....#E.#
