############
#..#....#..#
#..#....#..#
#..####.#..#
#....#..#..#
#....#..#..#
#....#..#..#
E.#.##..#S.#
