############
#..#....#..#
#..#....#..#
#..####.#..#
#....#..#..#
#....#..#.##
#....#..#..#
E.#.##.##S##
